8 8
2
6
4
4 2
   0;    0;    0;    0;    0;    0;    0;    0
   0;    0;    0;    1;    1;    0;    2;    0
   0;    1;    1;    1;    1;    2;    2;    0
   0;    1;    1;   1P;    1;    2;   2P;    0
   0;    3;    1;    1;    1;    2;    2;    0
   0;    1;    1;    1;    1;    2;    2;    0
   0;    1;   1P;    1;    1;    2;    0;    0
   0;    0;    0;    0;    0;    0;    0;    0
